59x15
11111111111111111111111111111111111111111111111111111111111
1*                3                              43       1
1                    43           55             43       1
1                 1  11                          35       1
1         4   4                   22111    1   2111       1
111                             4    11                   1
1 411                                11                   1
1         1111                  1                         1
1              5        11        3            3      11111
1                       1                                 1
1 222         11             11                 113       1
1                            11            222211111111   1
1         3 3                11                 111       X
1                            11                 111        
11111111111111111111111111111111111111111111111111111111111
